Complex_ID,Latitude,Longitude,MEAN_Median_Inc,SUM_Total_Popu,SUM_Male_Total,SUM_Female_Tot,SUM_White_Alon,SUM_Black_Alon,SUM_Hispanic_L,SUM_Non_Hispan
398,40.77362,-73.959874,134178.75,47275,20936,26339,40094,372,44312,2963
399,40.768141,-73.96387,177047.8889,44931,19397,25534,36445,576,41252,3679
403,40.746081,-73.982076,155538,48537,23030,25507,29953,2794,43228,5309
404,40.74307,-73.984264,183811,53878,26223,27655,34329,3474,48862,5016
405,40.739864,-73.986599,176921.1,60407,28990,31417,39826,4033,55036,5371
407,40.730054,-73.99107,172256.5385,59824,29542,30282,39944,2724,53912,5912
409,40.722301,-73.997141,132543.6667,35790,17696,18094,20300,1429,31361,4429
413,40.707557,-74.011862,154197.3333,53362,24756,28606,33567,2993,48759,4603
414,40.704817,-74.014065,171196.8,26386,13060,13326,17148,1096,24161,2225
416,40.903125,-73.85062,74399,17611,8685,8926,1052,11722,13798,3813
417,40.898379,-73.854376,80233,25182,12115,13067,3229,13147,17888,7294
418,40.893193,-73.857473,59540,31604,14908,16696,3776,16828,21590,10014
419,40.888022,-73.860341,50741.66667,29701,13983,15718,2466,17446,19591,10110
420,40.883895,-73.862633,52531.22222,29928,13609,16319,2267,17698,19612,10316
421,40.87785,-73.866256,48705.83333,32481,15760,16721,3369,13247,16469,16012
422,40.871356,-73.867164,56578.36364,26913,12837,14076,2178,12031,14173,12740
423,40.865462,-73.867352,46248.25,36548,17013,19535,6340,11832,18381,18167
424,40.857192,-73.867615,60196.63636,37686,17997,19689,9294,7824,18285,19401
425,40.848828,-73.868457,49237.875,21163,10551,10612,4523,4136,9619,11544
426,40.841894,-73.873488,39056.16667,18428,8945,9483,2211,4962,5388,13040
427,40.840295,-73.880049,29398.33333,29991,14230,15761,3309,12046,10147,19844
428,40.837288,-73.887734,31894,27089,13241,13848,2335,11071,10224,16865
429,40.829993,-73.891865,40777.22222,37275,17996,19279,2965,15664,14553,22722
430,40.824073,-73.893064,40796.45455,44859,21358,23501,3634,13459,12935,31924
431,40.822181,-73.896736,38044.75,54822,25318,29504,4511,16262,16282,38540
432,40.819585,-73.90177,36189.83333,62191,28443,33748,6198,18341,18300,43891
433,40.81649,-73.907807,34971.88889,38710,17767,20943,3793,12105,11098,27612
434,40.816109,-73.917757,23556.1,49651,22350,27301,6035,18823,17113,32538
436,40.82388,-73.93647,52668,61761,28622,33139,7678,31471,40979,20782
437,40.820421,-73.936245,55946.66667,60864,28208,32656,7100,37611,44754,16110
438,40.814229,-73.94077,56795.5,59236,27779,31457,8469,35378,45473,13763
439,40.807754,-73.945495,68204,45838,21538,24300,12275,21951,37688,8150
440,40.802098,-73.949625,62838.5,47849,23331,24518,11983,22969,37456,10393
441,40.799075,-73.951822,54880.11111,46607,22410,24197,10430,22042,34852,11755
442,40.8883,-73.830834,57318.4,19676,9247,10429,1164,13592,14764,4912
443,40.878663,-73.838591,72181.6,26829,12427,14402,1622,18982,20000,6829
444,40.869526,-73.846384,80676.55556,29119,13714,15405,3805,16554,20344,8775
445,40.858985,-73.855359,78686.85714,18830,9060,9770,7176,3141,12355,6475
446,40.854364,-73.860495,88223.71429,21830,10796,11034,7622,3031,12512,9318
447,40.7596,-73.83003,55145,34659,15689,18970,2661,1004,29897,4762
448,40.754622,-73.845625,0,0,0,0,0,0,0,0
449,40.75173,-73.855334,62035,29652,16476,13176,4339,1928,5953,23699
450,40.749865,-73.8627,76180.125,52306,27507,24799,7354,1545,7089,45217
451,40.749145,-73.869527,80754.0625,57214,30751,26463,7436,1283,12222,44992
452,40.748408,-73.876613,70405.29412,84737,44455,40282,14389,1433,30003,54734
453,40.747659,-73.883697,71959.25,66761,33849,32912,15953,1403,31118,35643
455,40.746325,-73.896403,72028.5,47444,23445,23999,12093,691,31593,15851
456,40.74563,-73.902984,80186.11111,36526,17431,19095,10579,435,23918,12608
457,40.744149,-73.912549,73614.18182,38210,18435,19775,15088,572,24016,14194
458,40.743132,-73.918435,76092.75,44571,22051,22520,18671,790,28274,16297
459,40.743781,-73.924016,69608.09091,30084,14901,15183,12928,781,20211,9873
460,40.744587,-73.930997,30642.125,8597,4690,3907,2658,715,5804,2793
461,40.750582,-73.940202,96361.33333,21442,10823,10619,6719,2868,17540,3902
463,40.742216,-73.948916,92075.4,9967,5548,4419,4852,714,8599,1368
464,40.742626,-73.953581,104426.2222,22349,11680,10669,11905,1030,19896,2453
471,40.755882,-74.00191,137175.8,17852,9529,8323,8809,1634,14983,2869
475,40.784318,-73.947152,101696,61717,27094,34623,28980,9710,46411,15306
476,40.777891,-73.951787,161366,83170,36581,46589,63711,3509,75237,7933
477,40.768799,-73.958424,149837.1,59801,25962,33839,48928,489,55814,3987
501,40.643748,-74.073643,67443,9394,4439,4955,3064,3812,6705,2689
502,40.636949,-74.074835,58916.75,13078,6532,6546,4547,3809,7907,5171
503,40.627915,-74.075162,54029.25,14372,6784,7588,5943,3755,9410,4962
504,40.621319,-74.071402,58752.25,12865,6196,6669,6107,1836,9767,3098
505,40.603117,-74.084087,80962,12682,6455,6227,8406,471,11007,1675
506,40.596612,-74.087368,88755,13217,6660,6557,9796,231,12193,1024
507,40.588849,-74.09609,92760,27701,13800,13901,19188,948,24069,3632
508,40.583591,-74.103338,85442,16127,7956,8171,10800,927,13280,2847
509,40.578965,-74.109704,101284.3333,11969,5713,6256,8999,310,9691,2278
510,40.57348,-74.11721,112950.25,18508,8659,9849,14209,837,15426,3082
511,40.56511,-74.12632,115213,23018,11404,11614,17486,715,19805,3213
512,40.5564,-74.136907,80671.25,18822,9753,9069,14137,104,15936,2886
513,40.551231,-74.151399,126858.6,27972,13545,14427,23170,168,24636,3336
514,40.544601,-74.16457,130103.75,21571,10510,11061,17803,225,18592,2979
515,40.54046,-74.178217,100558,4616,1939,2677,4002,43,4485,131
516,40.533674,-74.191794,118909.8,27337,13120,14217,23466,458,25214,2123
517,40.525507,-74.200064,127963.6667,20586,10331,10255,18634,120,18773,1813
518,40.52241,-74.217847,96825.25,24036,11638,12398,21239,101,21684,2352
519,40.519631,-74.229141,106600,26713,13505,13208,22523,73,23243,3470
522,40.512764,-74.251961,148914,4801,2488,2313,3630,4,3681,1120
523,40.516578,-74.242096,148914,4801,2488,2313,3630,4,3681,1120
601,40.73779633,-73.997732,168771.1,51247,25470,25777,37687,1674,45352,5895
602,40.735066,-73.99041633,186822.25,61053,29199,31854,41884,3032,55510,5543
603,40.8183925,-73.9270345,38380,30992,14239,16753,4767,13928,13726,17266
604,40.8279495,-73.925741,48184.75,36512,17698,18814,5317,16733,18786,17726
605,40.8406375,-73.939847,50700.4,63754,30709,33045,12996,6803,18680,45074
606,40.747141,-73.945032,133116.8571,20475,10945,9530,9112,967,18283,2192
607,40.749643,-73.9878865,146756.3333,22857,10598,12259,13190,1773,20295,2562
608,40.6705595,-73.9890405,137320.2222,20812,10549,10263,13341,1234,16536,4276
609,40.7540215,-73.983266,114532.5,16388,8048,8340,8812,1811,14358,2030
610,40.751992,-73.97735933,126234.2222,35073,16174,18899,21221,1556,31864,3209
611,40.755746,-73.9875808,87664,18071,9677,8394,8609,2307,15385,2686
612,40.7573295,-73.9704875,145754.3,25966,12339,13627,18203,662,24062,1904
613,40.762593,-73.9676125,142025.8667,43929,19822,24107,33836,1039,40105,3824
614,40.7682715,-73.9818325,137231.75,42841,22477,20364,28035,1784,37523,5318
615,40.625657,-73.996624,61493.77778,33494,17868,15626,16466,606,27533,5961
616,40.746746,-73.891366,75433,61482,30841,30641,16282,1388,38934,22548
617,40.68416167,-73.97778867,161011.8182,37731,17418,20313,18302,7499,31710,6021
618,40.740335,-74.002134,146082.5455,62685,31370,31315,45617,2881,53420,9265
619,40.725606,-73.9954315,139778.3333,50513,24876,25637,33241,1943,44623,5890
620,40.693241,-73.990642,171555.6364,42091,19585,22506,27100,3556,38035,4056
621,40.678896,-73.904356,52558.9,29536,13618,15918,5210,14287,16888,12648
622,40.713154,-74.003766,89612.5,48803,22157,26646,25554,4287,43864,4939
623,40.71870125,-74.00058,83667,42172,20260,21912,22630,1483,38890,3282
624,40.712603,-74.0095515,111905,59858,28551,31307,38626,3443,54904,4954
625,40.718463,-73.9877755,68848.7,48174,23016,25158,20879,3640,39822,8352
626,40.6705125,-73.958688,89748.4,44113,20288,23825,14222,20372,37440,6673
627,40.680988,-73.9563375,113304,38488,17797,20691,15964,13443,32912,5576
628,40.71008875,-74.00783825,144585.375,44004,20558,23446,27554,3111,40082,3922
629,40.7134275,-73.9508465,140063.4444,36397,18617,17780,20199,1873,24790,11607
630,40.699622,-73.9119855,85993,43780,21332,22448,13941,4474,19332,24448
635,40.7025775,-74.013329,171196.8,26386,13060,13326,17148,1096,24161,2225
636,40.692259,-73.986642,164937.3,38470,17618,20852,19878,6116,34077,4393
271,40.756879,-73.92074,86027.3,26228,13481,12747,14639,885,19343,6885
272,40.752039,-73.928781,81193.125,14510,7799,6711,6108,533,10851,3659
273,40.748973,-73.937243,93415.66667,15453,8275,7178,6045,739,13428,2025
276,40.760167,-73.975224,149758.9091,16924,9460,7464,11077,884,15403,1521
277,40.762862,-73.981637,134751.1111,36744,21231,15513,23790,1804,31688,5056
278,40.702147,-73.801109,53913,20998,10555,10443,1845,4170,11966,9032
279,40.700486,-73.807969,55716.16667,24414,12596,11818,1920,4725,14018,10396
280,40.702566,-73.816859,70660,37240,19174,18066,6522,4502,21925,15315
282,40.744065,-73.949724,122258.1667,15976,8086,7890,7626,779,14055,1921
283,40.731352,-73.954449,114322.125,22650,11489,11161,15036,1093,18305,4345
284,40.724635,-73.951277,154470.3,29985,14668,15317,21427,852,26057,3928
286,40.706092,-73.950308,58678.5,48242,23722,24520,29268,3447,34502,13740
287,40.700377,-73.950234,52372.6,71226,34829,36397,44967,8550,54629,16597
288,40.694568,-73.949046,68505,45159,21478,23681,18937,14168,34680,10479
289,40.689627,-73.953522,98001.72727,47393,20732,26661,20448,15001,40863,6530
290,40.688873,-73.96007,118245,40786,18193,22593,20076,10880,35459,5327
291,40.688089,-73.966839,137022.7778,36095,16113,19982,17658,8768,31455,4640
292,40.687119,-73.975375,148217.3333,37233,17244,19989,18156,7392,32065,5168
293,40.889248,-73.898583,81293.4,11787,5559,6228,5071,1718,5984,5803
294,40.884667,-73.90087,71285.22222,32845,15551,17294,10809,4322,13755,19090
295,40.878856,-73.904834,58628.66667,48225,21897,26328,12692,8637,17409,30816
296,40.874561,-73.909831,54750,41492,18971,22521,12609,9244,16312,25180
297,40.869444,-73.915279,61072.4,19850,9183,10667,5507,2536,6449,13401
298,40.864621,-73.918822,57859.85714,40175,18884,21291,8477,5170,10178,29997
299,40.860531,-73.925536,53732.5,50839,23951,26888,10582,4876,12670,38169
300,40.855225,-73.929412,58212.28571,42177,21087,21090,11050,3573,12468,29709
301,40.849505,-73.933596,65255.4,69008,34733,34275,20331,5240,22456,46552
303,40.834041,-73.94489,43695.33333,56765,27005,29760,10533,14766,25806,30959
304,40.826551,-73.95036,66300.5,45353,22655,22698,9640,14147,23898,21455
305,40.822008,-73.953676,44009,47030,23885,23145,9555,15576,23205,23825
306,40.815581,-73.958372,68329.375,45189,21697,23492,14364,10897,28644,16545
307,40.807722,-73.96411,109251.625,42059,19333,22726,22318,4584,34875,7184
308,40.803967,-73.966847,101630.625,55698,25603,30095,28608,7003,41747,13951
309,40.799446,-73.968379,114394,68927,32636,36291,38023,8271,52376,16551
310,40.793919,-73.972323,131911.2222,80294,37045,43249,51483,6577,65093,15201
311,40.788644,-73.976218,175932.125,69106,32629,36477,53886,2157,60825,8281
312,40.783934,-73.979917,178594.1111,74442,34674,39768,59721,2085,67895,6547
313,40.778453,-73.98197,156000.5455,70042,32623,37419,51842,2289,64088,5954
314,40.77344,-73.982209,138002.8889,50730,23414,27316,35220,1775,45700,5030
316,40.761728,-73.983849,118072.5,40552,23498,17054,25649,2571,34720,5832
318,40.750373,-73.991057,123446.9,28614,13602,15012,15376,2724,24540,4074
319,40.747215,-73.993365,151411.1,41888,20574,21314,26245,3514,35724,6164
320,40.744081,-73.995657,144127.2,53051,26505,26546,35844,3436,45504,7547
321,40.74104,-73.997871,148112.7,57746,29124,28622,40429,3004,49499,8247
323,40.733422,-74.002906,147914.2222,42602,20181,22421,34379,1189,38523,4079
324,40.728251,-74.005367,149518.25,34765,16891,17874,25981,1243,31416,3349
325,40.722854,-74.006277,129007.4286,26286,12822,13464,18127,991,23799,2487
326,40.719318,-74.006886,107358,29662,13993,15669,20161,1492,26727,2935
327,40.715478,-74.009266,92455.5,42365,19891,22474,27329,2528,39033,3332
328,40.711835,-74.012188,150015.8889,63642,29973,33669,40376,3199,58289,5353
329,40.707513,-74.013783,148333.1429,40831,20438,20393,26405,1776,37722,3109
333,40.706821,-74.0091,183875.4,32501,15086,17415,20324,1940,30251,2250
334,40.697466,-73.993086,168386.3636,45977,22008,23969,32974,2438,42389,3588
336,40.690545,-73.985065,164937.3,38470,17618,20852,19878,6116,34077,4393
337,40.688246,-73.980492,171516.4444,29452,13678,15774,14442,4915,25874,3578
339,40.680829,-73.975098,156111.3,35094,16201,18893,18856,6238,29640,5454
340,40.675235,-73.971046,132556.8889,37948,17467,20481,26032,3311,34093,3855
341,40.671987,-73.964375,100668.7778,40713,18452,22261,20469,12335,36868,3845
343,40.669847,-73.950466,88907.25,48144,22522,25622,16992,22846,42958,5186
344,40.669399,-73.942161,73468.58333,42524,20797,21727,15800,19745,37508,5016
345,40.668897,-73.932942,60643.73333,44145,19977,24168,9961,27019,38458,5687
346,40.664717,-73.92261,41304.9,43584,18782,24802,2304,34325,39009,4575
347,40.661453,-73.916327,43216.09091,45806,20960,24846,2116,35917,40719,5087
348,40.662549,-73.908946,37518.3,39762,16988,22774,2729,26723,30036,9726
349,40.663515,-73.902447,37136.7,41734,16602,25132,3185,27082,29261,12473
350,40.664635,-73.894895,47268.4,36756,15815,20941,1799,25863,26188,10568
351,40.665449,-73.889395,58386.2,34756,16146,18610,1499,24880,26488,8268
352,40.666235,-73.884079,63462.27273,38218,18032,20186,1956,26480,29522,8696
353,40.667883,-73.950683,87146.28571,58216,27177,31039,21327,27594,52489,5727
354,40.662742,-73.95085,78982.58333,45630,21268,24362,15786,22841,40750,4880
355,40.656652,-73.9502,76197.66667,34557,15110,19447,5444,23746,31473,3084
356,40.650843,-73.949575,83020.44444,42459,19392,23067,4220,30527,37683,4776
357,40.645098,-73.948959,71980.54545,35481,16456,19025,1715,27210,31998,3483
358,40.639967,-73.948411,70910.33333,36840,17287,19553,1887,28166,33287,3553
359,40.632836,-73.947642,76362.83333,32446,15710,16736,6860,18578,29649,2797
360,40.852462,-73.828121,36597.4,15331,7251,8080,6795,1510,8012,7319
361,40.84681,-73.832569,40215.66667,21066,9369,11697,9703,1968,10594,10472
362,40.843863,-73.836322,49621,18516,8097,10419,7050,2186,8523,9993
363,40.839892,-73.842952,51054,20602,9494,11108,4950,2440,9178,11424
364,40.836488,-73.847036,55047,24365,12119,12246,2941,2408,10249,14116
365,40.834255,-73.851222,59470.625,35012,17247,17765,3703,7882,18279,16733
366,40.833226,-73.860816,59067.84615,68552,34694,33858,6257,18745,36034,32518
367,40.831509,-73.867618,45701.54545,53275,27029,26246,4571,13906,22423,30852
368,40.829521,-73.874516,39911.1,45225,22240,22985,2381,13372,15081,30144
369,40.828584,-73.879159,41056.83333,50836,24600,26236,2550,17267,18339,32497
370,40.826525,-73.886283,44426,38322,18176,20146,2207,14577,14465,23857
371,40.820948,-73.890549,41216,45452,21173,24279,3393,16575,15742,29710
372,40.816104,-73.896435,38110.83333,27565,13960,13605,2416,6745,6691,20874
373,40.812118,-73.904098,28099.2,34062,15948,18114,2745,11233,10368,23694
374,40.808719,-73.907657,31388.09091,35532,16687,18845,2372,11963,11175,24357
375,40.805368,-73.914042,31729.66667,34091,15741,18350,3862,9846,10203,23888
376,40.807566,-73.91924,29054.1,41018,18790,22228,4561,12170,12031,28987
377,40.810476,-73.926138,39262.66667,45065,21051,24014,6629,15474,16131,28934
378,40.886037,-73.878751,51023,10890,5111,5779,1730,1658,3326,7564
379,40.87975,-73.884655,66033.25,35807,17022,18785,6013,7779,14187,21620
380,40.873412,-73.890064,49406.88889,42536,20218,22318,4994,8436,12965,29571
381,40.86776,-73.897174,47518.07692,59573,29422,30151,6112,11414,13812,45761
382,40.862803,-73.901034,44405.4,57075,27968,29107,4521,11096,10938,46137
383,40.858407,-73.903879,42644.4,59433,27303,32130,6149,17044,15726,43707
384,40.853453,-73.907684,36620.58333,58071,25949,32122,6063,18254,17689,40382
385,40.84848,-73.911794,39183.66667,53523,23994,29529,5587,19104,19836,33687
386,40.844434,-73.914685,39139.375,64028,29782,34246,6072,22243,22713,41315
387,40.840075,-73.917791,42212.90909,60745,28840,31905,6977,18387,18482,42263
388,40.835537,-73.9214,38776.16667,58008,28749,29259,6105,20200,20821,37187
391,40.813224,-73.929849,38475.85714,37819,17376,20443,5880,15442,15837,21982
392,40.804138,-73.937594,48003.66667,29277,13802,15475,5318,11856,16930,12347
393,40.798629,-73.941617,49865.36364,57127,27469,29658,9992,23350,33656,23471
394,40.79502,-73.94425,40178.58333,64920,29680,35240,11980,24074,36804,28116
395,40.7906,-73.947478,55965.88889,47216,20099,27117,12486,11344,27149,20067
396,40.785672,-73.95107,99949.8,66467,28839,37628,37668,7128,51143,15324
397,40.779492,-73.955589,132449.2857,70281,31380,38901,56893,1056,64557,5724
141,40.674772,-73.957624,115378.9,47735,21831,25904,19407,18869,42001,5734
143,40.868072,-73.919899,62861.57143,38223,18076,20147,9830,4301,11957,26266
144,40.865491,-73.927271,47992.33333,50339,22912,27427,10391,4487,12287,38052
145,40.859022,-73.93418,106098,35247,17659,17588,17265,2379,19953,15294
146,40.851695,-73.937969,103837.5714,42718,20221,22497,18518,3059,22522,20196
147,40.847391,-73.939704,85002,64002,31032,32970,20787,4921,24520,39482
149,40.836013,-73.939892,46266.90909,60524,28848,31676,11310,15581,27016,33508
150,40.830518,-73.941514,52596.33333,76568,36066,40502,12955,25933,40937,35631
151,40.824783,-73.944216,59481,59031,28845,30186,11541,23559,35780,23251
152,40.817894,-73.947649,54206.4,51306,25773,25533,8820,28652,38247,13059
153,40.811109,-73.952343,55264.83333,56836,27838,28998,14533,23322,40869,15967
154,40.805085,-73.954882,85665.22222,38966,18845,20121,12572,16104,32951,6015
155,40.800603,-73.958161,58436.875,42809,20810,21999,13440,13641,30582,12227
156,40.796092,-73.961454,75934.8,33312,14541,18771,15642,4789,23477,9835
157,40.791642,-73.964696,96453,42010,18546,23464,25332,4249,33751,8259
158,40.785868,-73.968916,134666.4,33805,15904,17901,26053,1202,29791,4014
159,40.781433,-73.972143,145100.3333,41009,19530,21479,33341,1206,37672,3337
160,40.775594,-73.97641,150077,40184,18754,21430,30888,722,36897,3287
162,40.762456,-73.985984,112527,39118,22774,16344,24859,2464,33408,5710
164,40.752287,-73.993391,128010.7778,23044,11048,11996,12059,2326,19597,3447
165,40.745906,-73.998041,131688.5,50630,24826,25804,32806,3340,42366,8264
167,40.732338,-74.000495,156377,57849,27944,29905,44907,1846,52537,5312
168,40.726227,-74.003739,128214,34595,16887,17708,25476,1212,31701,2894
169,40.720824,-74.005229,129007.4286,26286,12822,13464,18127,991,23799,2487
173,40.699337,-73.990531,124629.1429,32845,15012,17833,19788,4287,29597,3248
175,40.688484,-73.985001,160246.2727,39797,18266,21531,20924,5741,34561,5236
176,40.686113,-73.973946,148787.4286,45306,20774,24532,23469,8085,38843,6463
177,40.683263,-73.965838,139403.2222,37383,17146,20237,17500,9721,31203,6180
179,40.680438,-73.950426,90891.875,31269,14592,16677,11169,12898,26832,4437
180,40.679921,-73.940858,94128.44444,34414,16882,17532,8785,18714,30269,4145
181,40.679364,-73.930729,78545.88889,38502,17420,21082,6981,24848,32987,5515
182,40.678822,-73.920786,65359.625,38058,17391,20667,5611,27240,33415,4643
183,40.67834,-73.911946,67447.88889,36518,17527,18991,4426,24599,29804,6714
185,40.674542,-73.896548,50113.625,22830,10891,11939,3183,10901,11588,11242
186,40.67271,-73.890358,46621.1,29409,12993,16416,2946,15402,16739,12670
187,40.67413,-73.88075,63555.2,36536,17805,18731,2700,17153,24136,12400
188,40.675377,-73.872106,63321.22222,36142,17464,18678,2519,15696,25910,10232
189,40.677044,-73.86505,70751.3,38683,19589,19094,5550,8929,27210,11473
190,40.679371,-73.858992,76197.7,35404,17605,17799,6246,3507,23163,12241
191,40.679843,-73.85147,72929.54545,34632,16968,17664,7614,2088,21562,13070
192,40.680429,-73.843853,81738.11111,28443,14062,14381,7210,1898,17316,11127
193,40.681711,-73.837683,86295.5,26614,13415,13199,4391,2059,18474,8140
194,40.684331,-73.832163,89870.88889,26441,13979,12462,2781,2731,20376,6065
195,40.685951,-73.825798,91018.9,33654,17608,16046,1952,3766,26498,7156
196,40.672097,-73.835919,105334,9252,4552,4700,3189,726,4624,4628
197,40.668234,-73.834058,85143.6,16752,8248,8504,8887,1504,10853,5899
198,40.660476,-73.830301,49460.5,9190,4563,4627,6474,593,7189,2001
199,40.608382,-73.815925,112949,2323,1199,1124,1987,43,2108,215
200,40.588034,-73.813641,60068.33333,15026,6144,8882,6314,4703,11230,3796
201,40.585307,-73.820558,64501.75,20107,8737,11370,9779,5045,14982,5125
202,40.583209,-73.827559,72764.5,8617,3969,4648,4617,1770,6540,2077
203,40.580903,-73.835592,90063,9175,4677,4498,6855,582,7111,2064
204,40.590927,-73.796924,72424.5,25437,11738,13699,7364,10583,18958,6479
205,40.592374,-73.788522,44672,18235,8523,9712,2025,11570,14120,4115
206,40.592943,-73.776013,45175,14337,6336,8001,1335,9224,10847,3490
207,40.595398,-73.768175,56217.85714,34017,15224,18793,4683,20302,26270,7747
208,40.600066,-73.761353,59334.8,28121,12707,15414,4476,14866,20809,7312
209,40.603995,-73.755405,70127.16667,37527,17441,20086,8987,15457,26011,11516
210,40.874811,-73.878855,44963.875,38105,18453,19652,6795,5726,13409,24696
211,40.873244,-73.887138,49543,48755,23316,25439,5650,9652,15315,33440
212,40.866978,-73.893509,44192.66667,57292,27515,29777,5193,10445,13869,43423
213,40.861296,-73.897749,37857.35714,70111,33884,36227,5674,16638,16507,53604
214,40.856093,-73.900741,39669.8,74637,34556,40081,6477,24930,22350,52287
215,40.85041,-73.905227,43176,60452,27265,33187,5598,24736,23541,36911
216,40.8459,-73.910136,43228.85714,53096,24460,28636,4048,19151,19636,33460
217,40.839306,-73.9134,40786,54784,26590,28194,7056,16317,17028,37756
218,40.833771,-73.91844,39177,74026,35902,38124,7422,29378,30211,43815
220,40.830135,-73.938209,53797.41667,65359,30802,34557,10343,26816,38547,26812
221,40.754203,-73.942836,90218,19315,9518,9797,5873,2823,15559,3756
222,40.759145,-73.95326,131538.5,6904,3186,3718,3193,983,6274,630
223,40.764629,-73.966113,155090.6667,29458,12813,16645,23455,580,27019,2439
224,40.763972,-73.97745,123524.4444,16034,8983,7051,10156,1001,14670,1364
225,40.758663,-73.981329,101683.1,16933,9709,7224,9284,1880,15115,1818
228,40.742878,-73.992821,178872.3,42901,21738,21163,28076,2949,37934,4967
231,40.718267,-73.993753,71507.81818,51767,25283,26484,19720,1912,45932,5835
232,40.723402,-73.989938,104370.9167,52500,26289,26211,30082,3842,42904,9596
234,40.713715,-73.990173,46457.625,49156,25655,23501,13585,3148,39637,9519
235,40.701397,-73.986751,80262.33333,21994,9729,12265,11252,4963,19292,2702
236,40.686145,-73.990862,179685.7,36634,17384,19250,24033,3129,32457,4177
237,40.680303,-73.995048,166412.2857,24391,12238,12153,19268,462,22359,2032
238,40.67358,-73.995959,104752.8,29757,14679,15078,16567,5623,22662,7095
240,40.666271,-73.980305,137711.5556,29430,13713,15717,21714,1030,26166,3264
241,40.660365,-73.979493,126769.3333,26570,13013,13557,20480,402,23600,2970
242,40.650782,-73.975776,119550.5714,16321,7847,8474,11889,1116,14342,1979
243,40.644041,-73.979678,91317.27273,33130,17252,15878,15648,2875,27336,5794
244,40.636119,-73.978172,68158,35464,17294,18170,21236,2251,31188,4276
245,40.629755,-73.976971,66322.25,28072,13846,14226,21780,1002,25642,2430
246,40.625322,-73.976127,65226.66667,23573,11775,11798,19658,291,22149,1424
247,40.620769,-73.975264,74402.57143,15003,8024,6979,10826,136,13694,1309
248,40.61514,-73.974197,74554,27153,13667,13486,16554,423,23357,3796
249,40.608944,-73.973022,76941.16667,37998,18684,19314,19679,464,32205,5793
250,40.603217,-73.972361,70718.625,18791,8989,9802,10341,476,16654,2137
251,40.596063,-73.973357,75512.57143,17967,8406,9561,10409,525,15865,2102
252,40.58962,-73.97425,68547.14286,27990,12817,15173,14183,3393,24096,3894
253,40.581011,-73.974574,55492.57143,27788,13132,14656,20879,632,25216,2572
254,40.712646,-73.783817,86058.42857,26392,13170,13222,2758,5159,22255,4137
255,40.71047,-73.793604,67515.54545,41085,20411,20674,3141,8245,32370,8715
256,40.707564,-73.803326,72094.9,44494,22446,22048,4095,6938,29916,14578
257,40.70546,-73.810708,74132.66667,28948,15043,13905,2581,4884,17602,11346
258,40.709179,-73.820574,73327,23876,11804,12072,7051,4484,17974,5902
259,40.714441,-73.831008,92909.45455,30992,14581,16411,14035,2216,24406,6586
260,40.718331,-73.837324,116844.75,25761,11720,14041,13566,684,22185,3576
261,40.721691,-73.844521,123024.8889,41711,19475,22236,22810,1189,34752,6959
262,40.726523,-73.852719,92356.36364,56455,26747,29708,29066,2278,46744,9711
263,40.729846,-73.861604,83890.33333,40374,18967,21407,17695,1952,32469,7905
264,40.733106,-73.869229,73062.11111,45644,22254,23390,10952,5449,32106,13538
265,40.737015,-73.877223,75087.3,42931,20976,21955,3614,891,29222,13709
266,40.742454,-73.882017,64747.72727,52102,26442,25660,4128,695,28550,23552
268,40.749669,-73.898453,77027,36290,17941,18349,9785,416,24632,11658
269,40.752885,-73.906006,65213.63636,27220,12912,14308,8256,1160,16596,10624
270,40.756312,-73.913333,73132.18182,25823,12478,13345,12714,1497,18095,7728
1,40.775036,-73.912034,107187.3,30146,15089,15057,19659,930,23703,6443
2,40.770258,-73.917843,110305.75,42232,21192,21040,25598,1186,32559,9673
3,40.766779,-73.921479,103852,35655,18186,17469,20188,1057,27254,8401
4,40.76182,-73.925508,98119.44444,40164,19976,20188,21380,2128,31107,9057
5,40.756804,-73.929575,90276,24181,12643,11538,10605,1820,17729,6452
6,40.752882,-73.932755,74981.14286,9565,5120,4445,3423,461,7420,2145
8,40.764811,-73.973347,147591.3,16508,8893,7615,12555,526,15673,835
9,40.764664,-73.980658,141110.5556,36815,19896,16919,23412,1929,32012,4803
10,40.759901,-73.984139,116506,31358,18250,13108,18894,2116,27098,4260
13,40.745494,-73.988691,176999.5,42613,20909,21704,26361,3379,38359,4254
14,40.741303,-73.989344,187240.9091,51828,25597,26231,34195,3509,46778,5050
16,40.730328,-73.992629,175952.1818,53811,25906,27905,36466,2334,48534,5277
17,40.724329,-73.997702,128554.1538,50871,24768,26103,31365,2182,45060,5811
20,40.713282,-74.006978,124338.8889,53898,25294,28604,34419,3298,49068,4830
22,40.70722,-74.013342,148333.1429,40831,20438,20393,26405,1776,37722,3109
26,40.690635,-73.981824,130679.1818,35340,15678,19662,14939,7855,30511,4829
28,40.677316,-73.98311,163996.8571,24355,12266,12089,14841,3015,20740,3615
30,40.665414,-73.992872,110275.5556,21831,11830,10001,13279,1831,16301,5530
31,40.660397,-73.998091,76777,14225,8141,6084,8056,1378,8766,5459
32,40.655144,-74.003549,53282.625,16823,9345,7478,5876,2015,6749,10074
33,40.648939,-74.010006,65754.2,36043,18000,18043,7999,1555,13193,22850
34,40.645069,-74.014034,63245.77778,41527,20669,20858,8138,1231,18243,23284
35,40.641362,-74.017881,55791.3,36289,17385,18904,8317,826,19443,16846
36,40.634967,-74.023377,83739.15385,46125,22274,23851,23468,1275,31568,14557
37,40.629742,-74.02551,97248.44444,32006,15314,16692,19666,878,24375,7631
38,40.622687,-74.028398,95935.33333,27368,13092,14276,17680,581,21989,5379
39,40.616622,-74.030876,95991.44444,24216,11909,12307,16134,759,19775,4441
41,40.67705,-73.972367,135261.4,39099,18535,20564,26642,3270,34729,4370
42,40.661614,-73.962246,68655.5,21456,10290,11166,5196,12558,19636,1820
43,40.655292,-73.961495,77108.45455,48411,23127,25284,11155,25462,40122,8289
44,40.650527,-73.962982,84765.90909,44977,21773,23204,9821,22092,35579,9398
45,40.644031,-73.964492,98669.1,42224,20624,21600,10924,17244,34235,7989
46,40.640927,-73.963891,111091,30924,15364,15560,8683,11970,24723,6201
47,40.635082,-73.962793,92113,33229,15902,17327,11759,10050,27709,5520
48,40.62927,-73.961639,84619.25,22879,10526,12353,9547,5327,19707,3172
49,40.625039,-73.960803,80875.18182,32162,15973,16189,17515,3578,28791,3371
50,40.617618,-73.959399,67908.77778,33956,17161,16795,22011,2724,30913,3043
51,40.60867,-73.957734,70956.2,34677,17589,17088,25087,864,31688,2989
52,40.5993,-73.955929,63075.91667,36273,17914,18359,21828,1286,33066,3207
53,40.595246,-73.955161,70026.18182,33231,16787,16444,19256,1203,29818,3413
54,40.586896,-73.954155,80786.25,30898,14803,16095,19948,480,28084,2814
55,40.577621,-73.961376,43757.55556,31059,14327,16732,21347,829,27597,3462
56,40.576312,-73.968501,41148.66667,32917,14968,17949,24773,863,30444,2473
57,40.576127,-73.975939,45747.2,19452,9422,10030,15354,681,17682,1770
58,40.577422,-73.981233,42010.75,17450,7921,9529,6036,4994,13122,4328
59,40.646292,-73.994324,56536.25,19966,10188,9778,5234,337,12903,7063
60,40.640914,-73.994304,64194.72727,43490,22568,20922,23630,860,33567,9923
61,40.63626,-73.994791,52815.33333,62029,31059,30970,47972,833,55530,6499
62,40.631435,-73.995476,52309.72727,45523,23206,22317,35602,247,41505,4018
64,40.619589,-73.998864,68408.09091,37065,19270,17795,12106,645,29234,7831
65,40.613501,-74.00061,70523.16667,37745,18731,19014,14546,275,31513,6232
66,40.607954,-74.001736,68405.63636,37073,18526,18547,14764,431,29298,7775
67,40.604556,-73.998168,64359.75,42291,20989,21302,17992,1277,34632,7659
68,40.601875,-73.993728,62640.9,39367,18991,20376,15844,840,32590,6777
69,40.597704,-73.986829,74305.44444,33232,15974,17258,11826,523,27982,5250
70,40.588841,-73.983765,65521.14286,23474,11008,12466,7087,3170,18874,4600
71,40.635064,-74.011719,57201.33333,34463,16739,17724,4270,435,26264,8199
72,40.631386,-74.005351,60296.09091,30351,16014,14337,9594,312,26308,4043
74,40.620671,-73.990414,72026.9,31022,15786,15236,13943,431,26287,4735
75,40.61741,-73.985026,66990.22222,30388,15251,15137,14535,531,25481,4907
76,40.611815,-73.981848,71513.75,44199,22129,22070,18143,602,36480,7719
77,40.603923,-73.980353,80868.3,34508,16621,17887,14102,473,29792,4716
78,40.597473,-73.979137,78818.375,22632,10534,12098,7894,255,19684,2948
79,40.592721,-73.97823,64064.42857,23107,10366,12741,8247,3009,19718,3389
80,40.700492,-73.828294,88551,26962,13868,13094,8059,2712,17775,9187
81,40.697418,-73.836345,91393.44444,21242,10624,10618,4913,1950,13080,8162
82,40.695178,-73.84433,86004.5,20493,10331,10162,4429,866,10122,10371
83,40.693879,-73.851576,85339.84615,34212,17652,16560,8131,1622,15687,18525
84,40.692435,-73.86001,77352.77778,29472,14932,14540,5557,1961,12341,17131
85,40.691324,-73.867139,64409.25,23203,11742,11461,3891,1922,7885,15318
86,40.689941,-73.87255,65900.125,24479,12187,12292,5099,3522,7526,16953
87,40.683194,-73.873785,65640.6,35625,18154,17471,5657,8908,15623,20002
88,40.68141,-73.880039,53518,31493,15268,16225,4483,9106,13745,17748
89,40.679947,-73.884639,54956.5,34367,15911,18456,4927,10235,12699,21668
90,40.678024,-73.891688,48626.77778,23579,11451,12128,3351,9289,9596,13983
91,40.676992,-73.898654,51971.22222,23192,10759,12433,3503,10050,10739,12453
93,40.682893,-73.910456,74717.375,29315,13643,15672,6826,14536,21621,7694
94,40.68637,-73.916559,81436.09091,46380,21176,25204,9863,24550,34663,11717
95,40.68963,-73.92227,76194.41667,50398,22907,27491,10512,23040,35840,14558
96,40.693342,-73.928814,89789.54545,42799,20290,22509,11304,16272,30228,12571
97,40.697207,-73.935657,74112.1,35389,16856,18533,9007,11449,21077,14312
98,40.70026,-73.941126,66438.84615,47472,22140,25332,15847,11174,27440,20032
99,40.703869,-73.947408,64591.72727,48375,24059,24316,26959,3783,32424,15951
100,40.70687,-73.953431,58047.11111,45236,22412,22824,28513,2213,32840,12396
101,40.708359,-73.957757,96845.63636,59710,29274,30436,39055,2788,43817,15893
103,40.72028,-73.993915,89467,41428,20288,21140,18527,1902,36439,4989
107,40.706476,-74.011056,166011.7143,42648,19992,22656,26541,2101,39375,3273
108,40.711396,-73.889601,58514.16667,10206,4991,5215,5696,266,6063,4143
109,40.706186,-73.895877,85895.57143,25129,12534,12595,13577,715,14919,10210
110,40.704423,-73.903077,91660.1,42320,20504,21816,21804,1715,24029,18291
111,40.702762,-73.90774,85639.91667,50845,25490,25355,21090,2865,23634,27211
113,40.698664,-73.919711,76642.54545,46117,21897,24220,12272,7524,20236,25881
114,40.697857,-73.927397,91304.6,39632,19138,20494,13075,6261,20566,19066
118,40.732849,-73.986122,160470.5455,73416,35643,37773,50267,3555,65453,7963
119,40.730953,-73.981628,130799.3,74268,36444,37824,51487,3483,64496,9772
120,40.717304,-73.956872,164200,46646,23043,23603,27451,2575,33988,12658
122,40.714565,-73.944053,112289.7273,36385,17558,18827,18897,4679,24537,11848
123,40.711926,-73.94067,104122.4,32359,15309,17050,15635,4641,20614,11745
124,40.707739,-73.93985,71843.5,29754,13066,16688,10257,5560,16021,13733
125,40.706152,-73.933147,78204.83333,16680,9409,7271,6895,1623,9184,7496
126,40.706607,-73.922913,71311.375,26135,13191,12944,10354,2591,13951,12184
127,40.703811,-73.918425,79454.75,32327,15752,16575,12383,2616,15507,16820
129,40.695602,-73.904084,80234.6,30427,15273,15154,8500,3652,11446,18981
130,40.688764,-73.904046,60901.5,20911,10108,10803,5741,5413,11175,9736
131,40.682829,-73.905249,51668.5,14259,7083,7176,3557,6907,9606,4653
133,40.675345,-73.903097,50699.44444,31918,14206,17712,3441,17390,19003,12915
134,40.669367,-73.901975,33788.75,35506,13784,21722,2712,21915,23172,12334
135,40.664038,-73.900571,39861.66667,36315,14929,21386,2161,24813,25553,10762
136,40.658733,-73.899232,56750.5,26510,11339,15171,1341,19246,20713,5797
137,40.650573,-73.899485,78412.8,13630,5757,7873,651,10440,11673,1957
138,40.646654,-73.90185,78259.22222,22878,9841,13037,1186,16888,19709,3169
